XXXXXXXXXXXX
X@         X
X  *     * X
X          X
XXXXXXXXX XX
X.*        X
X.   *     X
X.       * X
XXX XXXXXXXX
X          X
X.        .X
XXXXXXXXXXXX