XXXXXXXXXXXX
XXX  *     X
X @        X
X X *.     X
X. X*      X
X X .      X
X*  **.    X
X.         X
XXXXXXXXXXXX