XXXXXXXXXXXX
X          X
X    @     X
X          X
X    *     X
X          X
X          X
X    .     X
XXXXXXXXXXXX