XXXXXXXXXXXX
XXX        X
X.@*       X
XXX *.     X
X.XX*      X
X X .      X
X*  **.    X
X    .     X
XXXXXXXXXXXX


